valorize: to decide the value of goods, resources, etc., in order to agree the price that should be charged for them
abjure: to say formally or publicly that you no longer agree with a belief or way of behaving
abnegate: to not allow yourself to have something, especially something you like or want; to not accept something, or to say that you do not have something
evanescent: lasting for only a short time, then disappearing quickly and being forgotten
ephemeral: lasting for only a short time
coda: a piece of music at the end of a longer piece of music, usually separate from the basic structure;the final or extra part of a speech, event, or piece of writing;the end of a syllable
panacea: something that will solve all problems;something that will cure all illnesses
nostalgia: a feeling of pleasure and also slight sadness when you think about things that happened in the past
mania: a very strong interest in something that fills a person's mind or uses up all their time;a state in which someone directs all their attention to one particular thing;a state of extreme physical and mental activity, often involving a loss of judgment and periods of euphoria
cornucopia: a large amount or supply of something
euphoria: extreme happiness, sometimes more than is reasonable in a particular situation
sequela: a result or condition that follows from a disease or illness
anathema: something that is strongly disliked or disapproved of;something that is considered completely wrong and offensive
enigma: someone or something that is mysterious and impossible to understand
stigma: a strong lack of respect for a person or a group of people or a bad opinion of them because they have done something society does not approve of
coma: a state of being unconscious, in which a person cannot be waked, usually caused by illness or injury
charisma: the ability to attract the attention and admiration of others, and to be seen as a leader
nirvana: a state of freedom from all suffering that Buddhists believe can be achieved by removing all personal wishes​；a state of being perfect
patina: a thin surface layer that develops on something because of use, age, or chemical action; a thin layer of a substance, usually green, that develops on the surface of some metals, caused by their reaction to air; something that makes someone or something seem to be something that they are not
persecute: to treat someone unfairly or cruelly over a long period of time because of their race, religion, or political beliefs, or to annoy someone by refusing to leave them alone
kin: family and relations
segregation: the policy of keeping one group of people apart from another and treating them differently, especially because of race, sex, or religion
brood: a group of young birds all born at the same time, or infml a person’s children; to think silently for a long time about things that make you sad, worried, or angry
exorbitant: Exorbitant prices, demands, etc. are much too large; The bill for dinner was exorbitant.
chimera: a hope or dream that is extremely unlikely ever to come true;
plethora: a very large amount of something, especially a larger amount than you need, want, or can deal with
bravura: impressive technical skill that is shown in an artistic performance or work
quota: a fixed, limited amount or number that is officially allowed
drab: boring, especially in appearance; having little colour and excitement
ad lib: said without any preparation or practice
glib: speaking or spoken in a confident way, but without careful thought or honesty
succumb: to lose the determination to oppose something, or to give up and accept something that you first opposed; She succumbed to temptation and had a second helping of ice cream.; If you succumb to an illness, you die from it.
plumb: to supply a building or a device with water pipes, or to connect a building or a device to a water pipe; (engineering) to measure how deep something is, especially water; to understand or discover all about something; exactly; completely; exactly straight, usually describing a vertical surface or line;
barb: an intelligent but critical remark that is intended to hurt
snub: to treat someone rudely, esp. by ignoring that person.
archaic: of or belonging to the past; from an ancient period in history
mosaic: a pattern or picture of many small pieces of colored stone or glass
prosaic: ordinary and not especially interesting or unusual
acerbic: used to describe something that is spoken or written in a way that is direct, clever, and cruel
cherubic: having a round, attractive face like that of a child
sporadic: happening sometimes; not regular or continuous
episodic: happening only sometimes and not regularly
soporific: causing sleep or making a person want to sleep
lethargic: lacking in energy; feeling unwilling or unable to do anything
synergy: 1+1>2 ; the combined power of a group of things when they are working together that is greater than the total power achieved by each working separately
synergistic: 1+1>2 : the synergistic effect of two drugs given at the same time
chic: stylish and fashionable
hagiographic: very admiring of someone and representing the person as perfect or much better than they really are
represent: DESCRIBE to show or describe something or someone
monolithic: very large, united, and difficult to change; A monolithic building or rock is large and solid
diabolical: very evil but often intelligent: a diabolical genius
catholic: including many different types of thing: As a young person he had more catholic tastes than he does now.
vitriolic: intentionally unkind or causing hurt: He launched a vitriolic attack on the senator, accusing him of shielding corrupt friends
panorama: a view from a great distance that covers a very large area: From the top floor of the hotel you get a panorama of the whole city.
pandemic: a dangerous disease that infects many people at one time; (of a disease) existing in almost all of an area or in almost all of a group of people, animals, or plants
endemic: (esp. of a disease or social condition) found particularly in a specific area or group
polemic: a piece of writing or a speech in which a person argues forcefully for or against someone or something
anemic: having too few red blood cells, causing a lack of energy
arrhythmia: a medical condition in which the heart does not beat with a regular rhythm, or at the normal rate.
arrhythmic: not rhythmic; without rhythm or regularity.
mimic: to copy the way someone speaks and moves, esp. in order to amuse or insult people; To mimic is also to have the same or similar effect as something else: This substance mimics calcium and can replace it in bones.​ a person who can copy the sounds or movements of other people
anthropogenic: caused by humans or their activities
laconic: using very few words to express what you mean: “I might,” was the laconic reply.
histrionic: (of behavior) showing a lot of emotion in order to persuade others or attract attention
chronic: ​(esp. of a disease or something bad) continuing for a long time
tonic: a liquid medicine intended to make you feel better generally rather than treating a particular health problem; A tonic is also anything that makes you feel better
embryonic: of or relating to an embryo; If a plan or process is an embryonic stage, it is in a very early stage of development
rune: any of the letters of an ancient alphabet cut into stone or wood in the past by the people of northern Europe, or any similar mark with a secret or magic meaning : runic
cynic: a person who believes that other people are interested only in themselves and therefore doubts that they can be good
stoic: not showing or not feeling any emotion, esp. in a situation in which the expression of emotion is expected:He is somewhat stoic as he speaks of his past.
epic: a book or movie that is long and contains a lot of action, usually about a subject from the past; An epic is also a long poem about events in the past, often involving gods or kings and queens; ​happening over a long period and including a lot of difficulties
philanthropic: helping poor people, especially by giving them money
misanthropic: not liking other people
myopic: not able to see clearly things that are far away; unable to understand a situation or the way actions will affect it in the future
choleric: very angry or easily annoyed
mesmeric: making you give your attention completely so that you cannot think of anything else: music with a repetitive, slightly mesmeric quality
generic: relating to or shared by a whole group of similar things; not specific to any particular thing; Generic also means not having a trademark; ​a product, esp. a drug, that is no longer owned or legally controlled by a particular company
esoteric: intended for or understood by only a few people who have special knowledge: Literary readings can sometimes seem esoteric, but we are trying to make them more attractive to more people.
meteoric: If something is described as meteoric, it is sudden and usually brief: a meteoric rise to fame
panegyric: a speech or piece of writing that praises someone very much and does not mention anything bad about them
lyric: (especially of poetry and songs) expressing personal thoughts and feelings: William Wordsworth wrote lyric poetry/was a lyric poet.
intrinsic: basic to a thing, being an important part of making it what it is: Each human being has intrinsic dignity and worth.
melodramatic: tending to behave or show emotion in ways that are more extreme than usual
pragmatic: based on practical judgments rather than principles
phlegmatic: not easily excited or emotional; calm: He is a retired lawyer with a solid, phlegmatic manner.
dogmatic: (of a person or a group) strongly expressing your beliefs as if they were facts: He has written a stimulating but dogmatic book.
chromatic: relating to colours: a chromatic range/combination
monochromatic: containing or using only one color
somatic: relating to the body as opposed to the mind
automatic: able to operate independently of human control; (of an action) done without thinking about it; happening according to rules that are certain to be followed, and therefore not needing a decision: Citizenship is automatic for children born in the US.
traumatic: causing severe and lasting emotional shock and pain: Some of the most disturbed children had witnessed really traumatic things, such as rape and murder.; causing worry or upset